26
20
72 72 72 72 73 -1 -1 -1 -1 71 72 72 72 72 72 72 72 72 72 72 72 72 72 72 72 72
72 72 72 72 73 -1 -1 -1 -1 71 72 72 72 72 72 72 72 72 72 72 72 72 72 72 72 72
72 72 95 82 83 50 51 52 53 81 82 82 82 82 82 82 82 82 82 82 82 82 82 94 72 72
72 72 73 -1 -1 -1 -1 -1 -1 -1 -1 -1 -1 -1 -1 -1 -1 -1 -1 -1 -1 -1 -1 71 72 72
72 72 73 -1 -1 -1 -1 -1 -1 -1 -1 -1 -1 -1 -1 -1 -1 -1 -1 -1 -1 -1 -1 71 72 72
72 72 73 -1 -1 -1 -1 -1 -1 -1 -1 -1 -1 -1 -1 -1 -1 -1 -1 50 51 51 53 71 72 72
72 72 73 -1 -1 -1 -1 -1 -1 -1 -1 -1 -1 -1 -1 -1 -1 -1 -1 -1 -1 -1 -1 71 72 72
72 72 85 62 62 62 62 62 62 62 62 62 62 62 62 62 62 62 63 90 90 90 90 71 72 72
72 72 72 72 72 72 72 72 72 72 72 72 72 72 72 72 72 72 73 50 51 51 53 71 72 72
72 72 95 82 82 82 82 82 82 82 82 82 82 82 82 82 82 82 83 90 90 90 90 71 72 72
72 72 73 -1 -1 -1 -1 -1 -1 -1 -1 -1 -1 -1 -1 -1 -1 -1 -1 90 90 90 90 71 72 72
72 72 73 -1 -1 -1 -1 -1 -1 -1 -1 -1 -1 -1 -1 -1 -1 -1 -1 50 51 51 53 71 72 72
72 72 73 -1 -1 -1 -1 -1 -1 -1 -1 -1 -1 -1 -1 -1 -1 -1 -1 -1 -1 -1 -1 71 72 72
72 72 73 -1 -1 -1 -1 -1 -1 -1 -1 -1 -1 -1 -1 -1 -1 -1 -1 -1 -1 -1 -1 71 72 72
72 72 73 -1 50 51 53 90 90 50 51 51 51 51 51 51 53 90 90 90 61 62 62 84 72 72
72 72 73 -1 -1 -1 -1 90 90 90 90 90 90 90 90 90 90 90 61 62 84 72 72 72 72 72
72 72 73 -1 -1 -1 -1 90 90 90 90 90 90 90 90 90 90 90 71 72 72 72 72 72 72 72
72 72 73 50 51 51 53 61 62 62 62 62 62 62 62 62 62 62 84 72 72 72 72 72 72 72
72 72 73 -1 -1 -1 -1 71 72 72 72 72 72 72 72 72 72 72 72 72 72 72 72 72 72 72
72 72 73 -1 -1 -1 -1 71 72 72 72 72 72 72 72 72 72 72 72 72 72 72 72 72 72 72
