30
45
72 72 72 -1 10 11 11 12 -1 -1 72 72 72 72 72 72 72 72 72 72 72 72 72 72 72 72 72 72 72 72
72 72 72 -1 10 11 11 12 -1 -1 72 72 72 72 72 72 72 72 72 72 72 72 72 72 72 72 72 72 72 72
-1 -1 -1 -1 10 11 11 12 72 72 72 72 72 72 72 72 72 72 72 72 72 72 72 72 72 72 72 72 72 72
1 1 1 1 42 43 11 40 1 7 1 1 1 7 1 1 1 7 1 1 1 7 1 1 1 1 1 1 1 1
11 11 11 11 11 11 11 11 11 17 43 11 11 17 11 11 11 17 11 23 11 17 11 11 11 13 11 11 11 13
11 11 11 11 43 43 11 11 11 27 11 11 11 27 11 13 11 27 11 11 11 27 11 11 11 23 11 11 11 23
11 11 11 11 11 11 11 11 11 37 11 11 11 37 11 11 11 37 11 11 11 37 31 11 11 11 30 21 21 21
-1 -1 -1 -1 -1 -1 -1 -1 -1 -1 -1 -1 -1 -1 -1 -1 -1 -1 -1 -1 -1 -1 10 11 11 11 12 -1 -1 72
-1 -1 -1 -1 -1 -1 -1 -1 -1 -1 -1 -1 -1 -1 -1 -1 -1 -1 -1 -1 -1 -1 10 11 11 11 12 -1 -1 72
-1 -1 -1 -1 -1 -1 -1 -1 -1 -1 -1 -1 -1 -1 -1 -1 -1 -1 -1 -1 -1 -1 10 11 11 11 12 -1 -1 72
-1 -1 -1 -1 -1 -1 -1 -1 -1 -1 -1 -1 -1 -1 -1 -1 -1 -1 -1 -1 -1 -1 10 11 11 11 12 72 -1 72
-1 -1 0 1 1 3 4 5 6 1 1 1 1 3 4 5 6 1 1 1 1 1 42 11 11 11 40 2 -1 72
-1 -1 10 13 11 11 14 15 11 11 11 11 11 11 14 15 11 11 13 11 11 11 11 11 11 11 11 12 -1 72
-1 -1 10 11 11 11 24 25 11 11 11 11 23 11 24 25 11 11 11 11 11 11 11 11 11 11 11 12 -1 72
-1 -1 10 11 11 11 24 25 11 11 11 11 11 11 24 25 11 11 11 11 11 11 11 11 11 11 11 12 -1 72
-1 -1 10 11 16 11 24 25 11 16 11 11 16 11 24 25 11 16 11 11 11 11 11 11 11 11 11 12 -1 72
-1 -1 10 11 26 11 24 25 11 26 43 11 26 11 24 25 11 26 11 11 11 11 11 11 11 11 11 12 -1 72
-1 -1 10 11 11 43 34 35 11 11 11 11 11 11 34 35 11 11 11 11 11 11 31 11 11 11 11 12 -1 72
-1 -1 -1 -1 -1 -1 -1 -1 -1 -1 -1 -1 -1 -1 -1 -1 -1 -1 -1 -1 -1 -1 10 11 11 11 11 12 -1 72
-1 -1 -1 -1 -1 -1 -1 -1 -1 -1 -1 -1 -1 -1 -1 -1 -1 -1 -1 -1 -1 -1 10 11 11 11 11 12 -1 72
-1 -1 -1 -1 -1 -1 -1 -1 -1 -1 -1 -1 -1 -1 -1 -1 -1 -1 -1 -1 -1 -1 10 11 11 11 11 12 -1 72
-1 -1 0 1 1 1 1 1 1 1 1 1 1 1 1 1 1 1 2 -1 -1 -1 10 11 11 11 11 12 -1 72
-1 -1 10 11 11 11 11 11 11 11 11 11 11 11 11 11 11 11 12 -1 -1 -1 10 11 11 11 11 12 -1 72
-1 -1 10 11 11 11 11 11 11 11 11 11 11 11 11 11 11 11 12 -1 -1 -1 10 11 11 11 11 12 -1 72
-1 -1 10 11 11 11 7 11 11 11 11 11 11 7 11 11 11 11 12 -1 -1 -1 10 11 11 11 11 12 -1 72
-1 -1 10 11 11 11 17 11 11 11 11 11 11 17 11 13 11 11 40 1 1 1 41 11 11 11 11 12 -1 72
-1 -1 10 11 11 11 17 11 11 11 11 11 11 17 11 11 11 11 11 11 11 11 11 11 11 11 11 12 -1 72
-1 -1 10 11 11 11 27 11 11 11 11 11 11 17 11 11 13 11 11 11 11 11 11 11 11 11 11 12 -1 72
-1 -1 10 11 11 11 7 11 11 11 11 11 11 17 11 11 11 11 11 11 11 11 11 11 11 11 11 12 -1 72
-1 -1 10 11 11 11 17 11 11 11 11 11 11 17 11 11 11 11 30 21 21 21 31 11 11 11 11 12 -1 72
-1 -1 10 16 11 16 17 11 11 11 11 11 11 17 16 11 16 11 12 -1 -1 -1 10 11 11 11 11 12 -1 72
-1 -1 10 26 11 26 17 11 11 11 11 11 11 17 26 11 26 11 12 -1 -1 -1 10 11 11 11 11 12 -1 72
-1 -1 10 11 11 11 27 11 11 11 11 11 11 27 11 11 11 11 12 -1 -1 -1 10 11 11 11 11 12 -1 72
-1 -1 10 11 11 11 37 11 11 11 11 11 11 37 11 11 11 11 12 -1 -1 -1 10 11 11 11 11 12 -1 72
-1 -1 -1 -1 -1 -1 -1 -1 -1 -1 -1 -1 -1 -1 -1 -1 -1 -1 -1 -1 -1 -1 10 11 11 11 11 12 -1 72
-1 -1 -1 -1 -1 -1 -1 -1 -1 -1 -1 -1 -1 -1 -1 -1 -1 -1 -1 -1 -1 -1 10 11 11 11 11 12 -1 72
-1 -1 -1 -1 -1 -1 -1 -1 -1 -1 -1 -1 -1 -1 -1 -1 -1 -1 -1 -1 -1 -1 10 11 11 11 11 12 -1 72
-1 -1 -1 -1 -1 -1 -1 -1 -1 -1 -1 -1 -1 -1 -1 -1 -1 -1 -1 -1 -1 -1 10 11 11 11 11 12 -1 72
90 90 0 1 1 1 1 1 1 1 1 1 7 1 1 1 7 1 1 1 7 1 41 11 11 11 11 23 -1 72
90 90 10 11 11 11 11 11 11 11 11 11 17 11 11 11 17 11 11 11 17 11 11 11 11 11 11 23 -1 72
90 90 10 11 16 11 11 11 11 11 16 11 27 11 11 11 27 11 11 11 27 11 11 23 11 23 11 12 -1 72
90 90 10 11 26 11 11 11 30 11 26 11 37 11 11 11 37 11 11 11 37 11 11 11 11 11 11 12 -1 72
90 90 62 62 -1 31 11 11 12 -1 -1 -1 -1 -1 -1 -1 -1 -1 -1 -1 -1 -1 -1 -1 -1 -1 -1 -1 -1 72
72 72 72 72 72 10 11 11 12 72 72 72 72 72 72 72 72 72 72 72 72 72 72 72 72 72 72 72 72 72
72 72 72 72 72 10 11 11 12 72 72 72 72 72 72 72 72 72 72 72 72 72 72 72 72 72 72 72 72 72
