35
20
72 72 72 72 72 72 72 72 72 72 72 72 72 72 72 72 72 72 72 72 72 72 72 72 72 72 72 72 72 72 72 72 72 72 72
72 72 72 72 72 72 72 72 72 72 72 72 72 72 72 72 72 72 72 72 72 72 72 72 72 72 72 72 72 72 72 72 72 72 72
72 72 72 72 72 72 72 72 72 72 72 72 72 72 72 72 72 72 72 72 72 72 72 72 72 72 72 72 72 72 72 72 72 72 72
72 72 72 72 72 -1 -1 -1 -1 -1 -1 -1 -1 -1 -1 -1 -1 -1 -1 -1 -1 -1 -1 -1 -1 -1 -1 -1 -1 -1 72 72 72 72 72
72 72 72 72 72 -1 0 1 1 1 1 1 1 1 1 1 1 1 1 1 1 1 1 1 1 1 1 1 2 -1 -1 72 72 72 72
72 72 72 -1 -1 0 41 11 11 11 11 11 11 11 11 23 11 11 11 11 11 11 11 11 11 11 11 11 11 2 -1 -1 72 72 72
72 72 72 -1 0 41 11 11 11 11 11 11 11 11 11 11 11 11 11 11 11 11 11 11 11 11 11 11 11 40 2 -1 72 72 72
72 72 72 -1 10 11 11 11 11 11 11 11 23 11 11 11 11 11 11 23 23 11 11 11 11 11 11 11 11 11 12 -1 72 72 72
72 72 72 -1 10 11 11 11 11 11 11 11 11 11 11 23 11 11 11 11 11 11 11 11 11 11 11 11 11 11 12 -1 72 72 72
72 72 72 -1 10 23 11 11 11 11 11 11 11 11 11 11 11 11 11 11 11 11 11 11 11 11 11 11 11 11 12 -1 72 72 72
-1 -1 -1 -1 10 11 11 11 11 11 11 11 11 11 11 11 11 11 11 11 11 11 11 11 11 11 11 11 11 11 12 -1 -1 -1 -1
1 1 1 1 41 11 11 11 11 11 11 11 11 11 11 11 11 11 11 11 11 11 11 11 11 11 11 11 11 11 40 1 1 1 1
11 11 11 23 11 11 3 4 5 6 3 4 5 6 11 11 11 11 11 3 4 5 6 3 4 5 6 11 11 11 11 23 11 11 11
11 23 11 11 23 11 11 14 15 11 11 14 15 11 11 11 11 11 11 11 14 15 11 11 14 15 11 11 11 11 11 11 23 11 11
11 11 23 11 11 13 11 24 25 11 11 24 25 11 16 11 11 11 16 11 24 25 11 11 24 25 11 11 11 11 23 11 11 11 11
11 11 11 11 11 11 11 34 35 11 11 34 35 11 26 11 11 11 26 11 34 35 11 11 34 35 11 11 23 11 11 11 11 11 11
-1 -1 -1 -1 -1 -1 -1 -1 -1 -1 -1 -1 -1 -1 -1 -1 -1 -1 -1 -1 -1 -1 -1 -1 -1 -1 -1 -1 -1 -1 -1 -1 -1 -1 -1
72 72 72 72 72 72 72 72 72 72 72 72 72 72 72 72 72 72 72 72 72 72 72 72 72 72 72 72 72 72 72 72 72 72 72
72 72 72 72 72 72 72 72 72 72 72 72 72 72 72 72 72 72 72 72 72 72 72 72 72 72 72 72 72 72 72 72 72 72 72
72 72 72 72 72 72 72 72 72 72 72 72 72 72 72 72 72 72 72 72 72 72 72 72 72 72 72 72 72 72 72 72 72 72 72
