20
15
72 72 72 72 72 72 72 72 72 72 72 72 72 72 72 72 72 72 72 72
72 95 82 82 82 82 82 82 82 82 82 82 82 82 82 82 82 82 94 72
72 73 -1 -1 -1 -1 -1 -1 -1 -1 -1 -1 -1 -1 -1 -1 -1 -1 71 72
72 73 -1 -1 -1 -1 -1 -1 -1 -1 -1 -1 -1 -1 -1 -1 -1 -1 81 82
72 73 -1 -1 -1 -1 -1 -1 -1 -1 -1 -1 -1 -1 55 52 56 57 90 90
72 73 -1 -1 -1 -1 -1 -1 -1 -1 -1 -1 -1 90 90 90 90 90 90 90
72 73 -1 -1 -1 -1 -1 -1 -1 -1 -1 -1 -1 -1 90 90 90 90 90 90
72 73 -1 -1 -1 -1 -1 -1 -1 -1 -1 -1 -1 -1 90 90 90 90 90 90
72 73 55 57 -1 -1 61 62 62 62 62 62 62 62 62 62 62 62 62 62
72 73 -1 -1 -1 -1 71 72 72 72 72 72 72 72 72 72 72 72 72 72
72 73 -1 -1 55 57 71 72 72 72 72 72 72 72 72 72 72 72 72 72
72 73 -1 -1 90 90 71 72 72 72 72 72 72 72 72 72 72 72 72 72
72 73 90 90 90 90 71 72 72 72 72 72 72 72 72 72 72 72 72 72
72 73 55 52 56 57 71 72 72 72 72 72 72 72 72 72 72 72 72 72
72 73 -1 -1 -1 -1 71 72 72 72 72 72 72 72 72 72 72 72 72 72
