12
15
72 72 95 83 -1 -1 -1 -1 81 94 72 72
72 72 73 -1 50 51 52 53 -1 71 72 72
72 72 73 -1 -1 -1 -1 -1 -1 71 72 72
72 72 73 -1 -1 -1 -1 -1 -1 71 72 72
72 72 73 -1 50 51 52 53 -1 71 72 72
72 72 73 -1 -1 -1 -1 -1 -1 71 72 72
72 72 73 -1 -1 -1 -1 -1 -1 71 72 72
72 72 73 -1 50 51 52 53 -1 71 72 72
72 72 73 -1 -1 -1 -1 -1 -1 71 72 72
72 72 73 -1 -1 -1 -1 -1 -1 71 72 72
72 72 73 -1 50 51 52 53 -1 71 72 72
72 72 73 -1 -1 -1 -1 -1 -1 71 72 72
72 72 73 -1 -1 90 -1 90 -1 71 72 72
72 72 73 -1 50 51 52 53 -1 71 72 72
72 72 85 63 -1 -1 -1 -1 61 84 72 72
