24
20
72 72 72 72 72 72 72 72 72 73 -1 -1 -1 -1 71 72 72 72 72 72 72 72 72 72
72 72 72 72 72 72 72 72 72 73 -1 -1 -1 -1 71 72 72 72 72 72 72 72 72 72
72 72 72 72 72 72 72 72 72 73 -1 -1 -1 -1 71 72 72 72 72 72 72 72 72 72
72 72 72 72 72 72 72 72 72 73 -1 -1 -1 -1 71 72 72 72 72 72 72 72 72 72
72 95 82 82 82 82 82 82 82 83 -1 -1 -1 -1 81 82 82 82 82 82 82 82 94 72
72 73 -1 -1 -1 -1 -1 -1 -1 -1 -1 -1 -1 -1 -1 -1 -1 -1 -1 -1 -1 -1 71 72
72 73 -1 -1 -1 -1 -1 -1 -1 -1 -1 -1 -1 -1 -1 -1 -1 -1 -1 -1 -1 -1 71 72
72 73 -1 -1 -1 -1 -1 -1 50 51 53 -1 -1 50 51 53 -1 -1 -1 -1 -1 -1 71 72
72 73 -1 -1 61 62 63 -1 -1 -1 -1 -1 -1 -1 -1 -1 -1 61 62 63 -1 -1 71 72
72 73 -1 -1 71 72 73 -1 -1 -1 -1 -1 -1 -1 -1 -1 -1 71 72 73 -1 -1 71 72
72 73 -1 -1 81 82 83 -1 -1 -1 -1 -1 -1 -1 -1 -1 -1 81 82 83 -1 -1 71 72
72 73 -1 -1 -1 -1 -1 -1 -1 -1 -1 -1 -1 -1 -1 -1 -1 -1 -1 -1 -1 -1 71 72
72 73 -1 -1 -1 -1 -1 -1 -1 -1 -1 -1 -1 -1 -1 -1 -1 -1 -1 -1 -1 -1 71 72
72 73 -1 -1 -1 -1 -1 76 63 -1 50 51 51 53 -1 61 77 -1 -1 -1 -1 -1 71 72
72 73 -1 -1 -1 -1 76 90 73 -1 -1 -1 -1 -1 -1 71 90 77 67 -1 -1 -1 71 72
72 73 -1 -1 -1 76 90 72 73 -1 -1 -1 -1 -1 -1 71 72 90 77 67 -1 -1 71 72
72 73 -1 -1 76 90 72 72 73 90 90 90 90 90 90 71 72 72 90 77 67 59 71 72
72 85 62 62 90 72 72 72 85 62 62 62 62 62 62 84 72 72 72 90 62 62 84 72
72 72 72 72 72 72 72 72 72 72 72 72 72 72 72 72 72 72 72 72 72 72 72 72
72 72 72 72 72 72 72 72 72 72 72 72 72 72 72 72 72 72 72 72 72 72 72 72
