26
20
-1 -1 -1 -1 -1 10 11 11 12 -1 -1 -1 -1 -1 -1 -1 -1 -1 -1 -1 -1 -1 -1 -1 -1 -1
-1 -1 -1 -1 -1 10 11 11 12 -1 -1 -1 -1 -1 -1 -1 -1 -1 -1 -1 -1 -1 -1 -1 -1 -1
-1 -1 -1 -1 -1 10 11 11 12 -1 -1 -1 -1 -1 -1 -1 -1 -1 -1 -1 -1 -1 -1 -1 -1 -1
-1 -1 -1 0 7 42 11 11 40 7 1 1 1 1 1 1 1 1 7 1 1 1 2 -1 -1 -1
-1 -1 -1 10 17 11 11 11 11 17 11 33 16 11 11 11 16 11 17 11 11 11 12 -1 -1 -1
-1 -1 -1 10 27 11 11 11 11 27 11 11 26 11 11 11 26 11 27 11 11 11 12 -1 -1 -1
-1 -1 -1 10 37 11 11 11 11 37 11 11 11 11 11 11 43 11 37 11 11 33 12 -1 -1 -1
-1 -1 -1 -1 -1 -1 -1 -1 -1 -1 -1 -1 -1 -1 -1 -1 -1 -1 -1 11 11 11 12 -1 -1 -1
-1 -1 -1 -1 -1 -1 -1 -1 -1 -1 -1 -1 -1 -1 -1 -1 -1 -1 -1 11 11 11 12 -1 -1 -1
-1 -1 -1 -1 -1 -1 -1 -1 -1 -1 -1 -1 -1 -1 -1 -1 -1 -1 -1 11 33 11 12 -1 -1 -1
-1 -1 -1 0 1 1 1 1 1 1 1 1 1 1 1 1 1 1 1 11 11 11 12 -1 -1 -1
-1 -1 -1 10 11 11 11 11 11 11 11 23 11 11 11 11 11 11 11 11 11 11 12 -1 -1 -1
-1 -1 -1 10 11 11 11 11 11 11 11 11 11 11 11 11 11 11 23 11 11 11 12 -1 -1 -1
-1 -1 -1 10 11 11 11 11 11 11 11 11 11 11 11 11 11 11 11 11 11 11 12 -1 -1 -1
-1 -1 -1 10 11 11 11 11 23 11 11 11 11 11 11 11 11 11 11 11 -1 -1 -1 -1 -1 -1
-1 -1 -1 10 11 11 11 11 11 11 11 11 11 11 11 11 11 11 -1 -1 -1 -1 -1 -1 -1 -1
-1 -1 -1 10 11 11 30 21 21 21 21 21 21 21 21 21 21 21 -1 -1 -1 -1 -1 -1 -1 -1
-1 -1 -1 10 11 11 12 -1 -1 -1 -1 -1 -1 -1 -1 -1 -1 -1 -1 -1 -1 -1 -1 -1 -1 -1
-1 -1 -1 10 11 11 12 -1 -1 -1 -1 -1 -1 -1 -1 -1 -1 -1 -1 -1 -1 -1 -1 -1 -1 -1
-1 -1 -1 10 11 11 12 -1 -1 -1 -1 -1 -1 -1 -1 -1 -1 -1 -1 -1 -1 -1 -1 -1 -1 -1
