30
15
72 72 72 72 72 72 72 72 72 72 72 72 72 72 72 72 72 72 72 72 72 72 72 72 72 72 72 72 72 72
72 72 -1 -1 -1 -1 -1 -1 -1 -1 -1 -1 -1 -1 -1 -1 -1 -1 -1 -1 -1 -1 -1 -1 -1 -1 -1 72 72 72
72 72 -1 0 1 1 1 1 1 1 1 1 1 1 1 1 1 1 1 1 1 1 1 1 1 2 -1 72 72 72
72 72 -1 10 11 11 11 11 11 11 11 11 11 11 11 11 11 43 11 11 43 11 11 11 11 12 -1 72 72 72
72 72 -1 10 11 11 11 11 11 11 11 11 11 11 11 11 11 11 11 11 11 11 11 11 33 12 -1 72 72 72
72 72 -1 -1 -1 -1 -1 -1 -1 -1 -1 -1 -1 -1 -1 -1 -1 -1 -1 -1 -1 -1 11 11 33 12 -1 72 72 72
-1 -1 -1 -1 -1 -1 -1 -1 -1 -1 -1 -1 -1 -1 -1 -1 -1 -1 -1 -1 -1 -1 11 11 11 12 -1 72 72 72
-1 -1 -1 -1 -1 -1 -1 -1 -1 -1 -1 -1 1 1 1 1 -1 -1 -1 -1 -1 -1 11 11 33 12 -1 -1 -1 -1
72 72 -1 0 1 1 1 1 1 2 7 1 1 1 1 1 1 7 0 1 1 1 11 11 11 40 1 1 1 1
72 72 -1 10 11 11 11 11 43 11 17 11 16 11 11 16 11 17 11 11 11 11 11 11 11 43 11 11 11 11
72 72 -1 10 11 23 43 11 11 11 27 11 26 43 11 26 11 27 11 11 11 11 11 11 11 11 11 11 43 11
72 72 -1 10 11 11 11 11 11 11 37 11 11 11 11 11 11 37 11 11 11 11 11 11 11 43 11 11 11 11
-1 -1 -1 -1 -1 -1 -1 -1 -1 -1 -1 -1 10 11 11 12 -1 -1 -1 -1 -1 -1 -1 -1 -1 -1 -1 -1 -1 -1
-1 -1 -1 -1 -1 -1 -1 -1 -1 -1 -1 -1 10 11 11 12 -1 -1 -1 -1 -1 -1 -1 -1 -1 -1 -1 -1 -1 -1
-1 -1 -1 -1 -1 -1 -1 -1 -1 -1 -1 -1 10 11 11 12 -1 -1 -1 -1 -1 -1 -1 -1 -1 -1 -1 -1 -1 -1
