24
17
72 72 72 72 72 72 72 72 72 72 72 72 72 72 72 72 72 72 72 72 72 72 72 72
72 72 72 72 72 72 72 72 72 72 72 72 72 72 72 72 72 72 72 72 72 72 72 72
72 72 -1 -1 -1 -1 -1 -1 -1 -1 -1 -1 -1 -1 -1 -1 -1 -1 -1 -1 -1 -1 72 72
72 72 -1 -1 -1 -1 -1 -1 -1 -1 -1 -1 -1 -1 -1 -1 -1 -1 -1 -1 -1 -1 72 72
72 72 -1 -1 -1 -1 -1 -1 -1 -1 -1 -1 -1 -1 -1 -1 -1 -1 -1 -1 -1 -1 72 72
72 72 -1 0 1 1 1 1 1 1 1 1 1 1 1 1 1 1 1 1 2 -1 72 72
72 72 -1 10 11 11 11 11 11 11 11 11 11 11 11 11 11 11 11 11 12 -1 72 72
72 72 -1 10 11 11 11 11 11 11 11 11 11 11 11 11 11 11 11 11 12 -1 72 72
72 72 -1 10 11 11 11 11 11 11 11 11 11 11 11 11 11 11 11 11 12 -1 72 72
1 1 1 42 11 11 11 11 11 11 11 11 11 11 11 11 11 23 11 11 12 -1 72 72
11 11 11 11 11 11 11 11 11 11 11 11 11 11 11 11 11 11 11 11 12 -1 72 72
11 11 11 11 11 11 11 11 11 11 11 11 11 11 11 11 23 11 11 11 12 -1 72 72
11 11 11 11 11 11 11 11 11 16 11 11 11 16 11 11 11 11 16 11 12 -1 72 72
-1 -1 -1 11 11 11 11 11 11 26 11 11 11 26 11 11 11 11 26 11 12 -1 72 72
72 72 72 87 -1 -1 11 11 11 11 11 11 11 11 11 11 11 11 11 11 12 -1 72 72
72 72 72 72 72 72 87 -1 -1 -1 -1 -1 -1 -1 -1 -1 -1 -1 -1 -1 72 72 72 72
72 72 72 72 72 72 72 72 72 72 72 72 72 72 72 72 72 72 72 72 72 72 72 72
