30
30
-1 -1 -1 -1 -1 -1 -1 -1 -1 -1 -1 -1 -1 -1 -1 -1 -1 -1 -1 -1 -1 -1 -1 -1 -1 -1 -1 -1 -1 -1
-1 -1 -1 -1 -1 -1 -1 -1 -1 -1 -1 -1 -1 -1 -1 -1 -1 -1 -1 -1 -1 -1 -1 -1 -1 -1 -1 -1 -1 -1
-1 -1 -1 -1 -1 -1 -1 -1 -1 -1 -1 -1 -1 -1 -1 -1 -1 -1 -1 -1 -1 -1 -1 -1 -1 -1 -1 -1 -1 -1
72 72 72 -1 -1 -1 -1 -1 -1 -1 -1 -1 -1 -1 -1 -1 -1 -1 -1 -1 -1 -1 -1 -1 -1 -1 -1 -1 -1 -1
72 72 72 -1 -1 -1 -1 -1 -1 -1 -1 -1 -1 -1 -1 -1 -1 -1 -1 -1 -1 -1 -1 -1 -1 -1 -1 -1 -1 -1
72 72 72 -1 -1 -1 -1 -1 0 1 1 1 1 1 1 1 1 1 1 1 1 2 -1 -1 -1 -1 -1 -1 -1 -1
72 72 72 -1 -1 -1 0 1 42 11 11 11 11 11 11 11 11 11 11 11 11 40 1 2 -1 -1 -1 -1 -1 -1
72 72 72 -1 0 1 42 11 11 11 11 11 11 11 11 11 11 11 11 11 11 11 11 40 1 2 -1 -1 -1 -1
72 72 72 -1 10 11 11 11 11 11 11 11 11 11 11 11 11 11 11 11 11 11 11 11 11 12 -1 -1 -1 -1
72 72 72 -1 10 11 11 11 11 11 11 11 11 11 11 11 11 11 11 11 11 11 11 11 11 12 -1 -1 -1 -1
72 72 72 -1 10 11 11 11 11 11 11 11 11 11 11 11 11 11 11 11 11 11 11 11 11 12 -1 -1 -1 -1
72 72 72 -1 10 11 11 11 11 11 11 11 11 11 11 11 11 11 11 11 11 11 11 11 11 12 -1 -1 -1 -1
72 72 72 -1 10 11 11 11 11 11 11 11 11 11 11 11 11 11 11 11 11 11 11 11 11 12 -1 -1 -1 -1
72 72 72 -1 10 11 11 11 11 11 11 11 11 11 11 11 11 11 11 11 11 11 11 11 11 12 -1 -1 -1 -1
72 72 72 -1 10 11 11 11 11 11 11 11 11 11 11 11 11 11 11 11 11 11 11 11 11 12 -1 -1 -1 -1
72 72 72 -1 10 11 11 11 11 11 11 11 11 11 11 11 11 11 11 11 11 11 11 11 11 12 -1 -1 -1 -1
72 72 72 -1 10 11 7 11 11 11 11 11 11 11 11 11 11 11 11 11 11 11 11 7 11 12 -1 -1 -1 -1
72 72 72 -1 10 11 17 11 11 11 11 11 11 11 11 11 11 11 11 11 11 11 11 17 11 12 -1 -1 -1 -1
-1 -1 -1 -1 10 11 17 11 11 11 11 11 11 11 11 11 11 11 11 11 11 11 11 17 11 12 -1 -1 -1 -1
-1 -1 -1 -1 10 11 17 11 11 7 11 11 11 11 11 11 11 11 11 11 7 11 11 17 11 12 -1 -1 -1 -1
1 1 1 1 42 11 17 11 11 17 11 11 11 11 11 11 11 11 11 11 17 11 11 17 11 40 1 1 1 1
11 11 11 11 11 11 27 11 11 27 11 11 11 11 11 11 11 11 11 11 27 11 11 27 11 13 11 11 11 11
11 11 11 11 11 11 7 11 11 17 11 11 11 11 11 11 11 11 11 11 17 11 11 7 11 11 13 11 11 11
11 11 11 11 11 11 17 11 11 17 11 11 11 11 11 11 11 11 11 11 17 11 11 17 11 11 11 11 11 11
11 11 72 72 11 11 27 11 11 17 11 11 11 11 11 11 11 11 11 11 17 11 11 27 11 11 72 72 72 72
72 72 72 72 87 11 37 11 11 27 11 11 11 11 11 11 11 11 11 11 27 11 11 37 11 86 72 72 72 72
72 72 72 72 72 87 72 72 11 37 11 11 11 11 11 11 11 11 11 11 37 11 72 72 86 72 72 72 72 72
72 72 72 72 72 72 72 72 87 66 -1 -1 -1 -1 -1 -1 -1 -1 -1 -1 66 86 72 72 72 72 72 72 72 72
72 72 72 72 72 72 72 72 72 72 72 72 72 72 72 72 72 72 72 72 72 72 72 72 72 72 72 72 72 72
72 72 72 72 72 72 72 72 72 72 72 72 72 72 72 72 72 72 72 72 72 72 72 72 72 72 72 72 72 72
