30
20
72 72 72 72 72 72 72 72 72 72 72 72 72 72 72 72 72 72 72 72 72 72 72 72 72 72 72 72 72 72
72 72 72 72 72 72 72 72 72 72 72 72 72 72 72 72 72 72 72 72 72 72 72 72 72 72 72 72 72 72
72 72 72 72 72 72 72 72 72 72 72 72 72 72 72 72 72 72 72 72 72 72 72 72 72 72 72 72 72 72
72 72 72 72 72 72 72 72 -1 -1 -1 -1 -1 -1 -1 -1 -1 -1 -1 -1 -1 -1 -1 -1 -1 -1 -1 -1 -1 -1
72 72 72 72 72 72 72 72 -1 0 1 1 1 1 1 1 1 1 1 1 1 1 1 1 1 1 1 1 1 1
72 72 72 72 72 -1 -1 -1 -1 10 11 11 11 11 11 11 11 11 11 11 11 11 11 11 11 11 11 11 11 11
72 72 72 72 -1 -1 0 1 1 41 11 11 11 11 11 11 11 11 11 11 11 33 11 11 11 11 11 11 11 11
72 72 72 72 -1 0 41 11 11 11 11 11 11 23 11 11 11 11 11 11 11 11 11 11 11 11 11 11 11 11
72 72 72 72 -1 10 11 11 11 11 11 11 11 11 11 11 11 11 11 11 11 11 11 11 11 33 21 21 21 21
72 72 72 72 -1 10 11 11 11 11 11 11 11 11 11 11 11 11 11 11 11 33 11 11 11 11 86 -1 -1 -1
72 72 72 72 -1 10 11 11 11 11 11 11 23 11 11 11 11 11 11 11 11 11 11 11 11 86 72 72 72 72
72 72 72 72 -1 10 11 23 11 11 21 21 21 21 21 21 21 21 21 21 21 21 21 11 86 72 72 72 72 72
72 -1 -1 -1 -1 10 23 23 11 11 -1 -1 -1 -1 -1 -1 -1 -1 -1 -1 -1 -1 -1 86 72 72 72 72 72 72
1 1 1 1 1 42 11 11 11 86 72 72 72 72 72 72 72 72 72 72 72 72 72 72 72 72 72 72 72 72
11 11 11 11 11 11 11 11 86 72 72 72 72 72 72 72 72 72 72 72 72 72 72 72 72 72 72 72 72 72
11 11 11 11 11 11 11 86 72 72 72 72 72 72 72 72 72 72 72 72 72 72 72 72 72 72 72 72 72 72
21 21 21 21 21 21 86 72 72 72 72 72 72 72 72 72 72 72 72 72 72 72 72 72 72 72 72 72 72 72
-1 -1 -1 -1 66 86 72 72 72 72 72 72 72 72 72 72 72 72 72 72 72 72 72 72 72 72 72 72 72 72
72 72 72 72 72 72 72 72 72 72 72 72 72 72 72 72 72 72 72 72 72 72 72 72 72 72 72 72 72 72
72 72 72 72 72 72 72 72 72 72 72 72 72 72 72 72 72 72 72 72 72 72 72 72 72 72 72 72 72 72
