30
20
72 72 72 72 72 72 -1 10 11 11 12 -1 72 72 72 72 72 72 72 72 72 72 72 72 72 72 72 72 72 72
72 72 72 72 72 72 -1 10 11 11 12 -1 72 72 72 72 72 72 72 72 72 72 72 72 72 72 72 72 72 72
72 72 72 -1 -1 -1 -1 10 11 11 12 -1 -1 -1 -1 -1 -1 -1 -1 -1 -1 -1 -1 -1 -1 -1 72 72 72 72
72 72 72 -1 0 1 1 42 11 11 40 1 1 1 1 1 1 1 1 1 1 1 1 1 2 -1 -1 72 72 72
72 72 72 -1 10 11 11 11 11 11 11 11 11 11 11 11 11 11 11 11 11 11 11 11 40 2 -1 72 72 72
72 72 72 -1 10 11 11 11 11 11 11 11 11 11 11 11 11 23 11 23 11 11 11 11 11 12 -1 72 72 72
72 72 72 -1 10 11 11 11 11 11 11 11 11 11 11 11 11 11 11 11 11 11 11 11 11 12 -1 72 72 72
72 72 72 -1 10 11 11 11 11 11 11 11 11 11 11 11 11 -1 -1 -1 11 11 11 11 11 12 -1 72 72 72
72 72 72 -1 10 11 11 11 11 11 11 11 23 11 11 11 11 -1 -1 -1 11 11 11 11 11 12 -1 72 72 72
72 72 72 -1 10 11 11 11 11 11 11 11 11 11 11 11 11 -1 -1 -1 11 11 11 11 11 12 -1 72 72 72
72 72 72 -1 10 11 11 11 23 23 7 11 11 11 7 11 11 1 1 1 11 11 11 11 11 12 -1 72 72 72
72 72 72 -1 10 11 11 11 11 11 17 11 11 11 17 11 11 11 11 11 11 11 11 11 11 12 72 72 72 72
72 72 72 -1 10 11 11 11 23 11 17 11 33 11 17 11 11 11 11 11 11 11 11 11 11 40 1 1 1 1
72 72 72 -1 10 11 11 11 11 11 17 11 33 11 17 11 11 23 11 11 11 16 11 11 11 11 16 11 11 11
72 72 72 -1 10 11 11 11 11 11 27 11 11 11 27 11 11 11 11 11 11 26 11 11 11 11 26 11 11 11
72 72 72 -1 10 11 11 11 11 11 37 11 11 11 37 11 11 11 11 11 11 11 11 11 11 11 11 11 11 11
72 72 72 -1 -1 -1 -1 -1 -1 -1 -1 -1 -1 -1 -1 -1 -1 -1 -1 -1 -1 -1 10 11 11 12 -1 -1 -1 -1
72 72 72 72 72 72 72 72 72 72 72 72 72 72 72 72 72 72 72 72 72 -1 10 11 11 12 -1 72 72 72
72 72 72 72 72 72 72 72 72 72 72 72 72 72 72 72 72 72 72 72 72 -1 10 11 11 12 -1 72 72 72
72 72 72 72 72 72 72 72 72 72 72 72 72 72 72 72 72 72 72 72 72 -1 10 11 11 12 -1 72 72 72
