20
15
72 72 72 72 72 72 72 72 72 72 72 72 72 72 72 72 72 72 72 72
72 72 72 72 72 72 72 72 72 72 72 72 72 72 72 72 72 72 72 72
72 72 72 -1 -1 -1 -1 -1 -1 -1 -1 -1 -1 -1 -1 -1 -1 72 72 72
72 72 -1 -1 0 1 1 1 1 1 1 1 1 1 1 2 -1 -1 72 72
72 72 0 1 42 11 11 11 11 11 11 11 11 11 11 40 2 -1 72 72
72 72 10 11 11 11 11 11 11 11 11 11 11 11 11 11 12 -1 72 72
72 72 10 11 11 11 11 11 11 11 11 11 11 11 11 11 12 -1 72 72
72 72 10 11 11 11 11 11 11 11 11 11 11 11 11 11 12 -1 72 72
72 72 10 11 11 11 11 11 11 11 11 11 11 11 11 11 12 -1 72 72
72 72 10 11 11 11 11 11 11 11 11 11 11 11 11 11 12 71 72 72
72 72 11 11 11 11 11 11 11 11 11 11 11 11 11 11 11 88 72 72
72 72 87 11 11 11 11 11 11 11 11 11 11 11 11 11 86 72 72 72
72 72 72 87 11 21 21 31 11 11 11 30 21 21 11 86 72 72 72 72
72 72 72 72 87 72 72 10 11 11 11 12 72 72 86 72 72 72 72 72
72 72 72 72 72 72 72 10 11 11 11 12 72 72 72 72 72 72 72 72
