20
20
72 72 72 72 72 72 72 72 72 72 72 72 72 72 72 72 72 72 72 72
72 72 72 72 72 72 72 72 72 72 72 72 72 72 72 72 72 72 72 72
72 72 72 95 82 82 82 82 82 82 82 82 82 94 72 72 72 72 72 72
72 72 72 73 -1 -1 -1 -1 -1 -1 -1 -1 -1 71 72 72 72 72 72 72
72 72 72 73 -1 -1 -1 -1 -1 -1 -1 -1 -1 71 72 72 72 72 72 72
72 72 95 83 -1 -1 -1 -1 -1 -1 -1 -1 -1 81 82 82 82 82 94 72
72 72 73 -1 -1 -1 -1 -1 -1 -1 -1 -1 -1 -1 -1 -1 -1 -1 71 72
72 72 73 -1 -1 -1 -1 -1 -1 -1 -1 -1 -1 -1 -1 -1 -1 -1 71 72
72 72 73 -1 -1 -1 -1 -1 -1 -1 -1 -1 -1 -1 -1 -1 -1 -1 71 72
72 72 73 -1 -1 -1 -1 90 -1 -1 -1 -1 -1 -1 -1 -1 -1 -1 71 72
72 72 73 50 51 51 53 61 62 62 62 62 62 62 63 -1 -1 -1 71 72
72 72 73 -1 -1 -1 -1 71 72 72 72 72 72 72 73 -1 -1 -1 71 72
82 82 83 -1 -1 -1 -1 81 82 82 82 82 82 82 83 55 56 57 71 72
-1 -1 -1 -1 -1 -1 -1 -1 -1 -1 -1 -1 -1 -1 -1 -1 -1 -1 71 72
-1 -1 -1 -1 -1 -1 -1 -1 -1 -1 -1 -1 -1 -1 -1 -1 -1 -1 71 72
-1 -1 -1 -1 -1 -1 -1 -1 -1 -1 -1 -1 -1 -1 -1 -1 -1 -1 71 72
-1 -1 -1 -1 -1 -1 -1 -1 -1 -1 -1 -1 -1 -1 -1 -1 -1 -1 71 72
62 62 62 62 62 62 63 50 51 51 53 61 62 62 62 62 62 62 84 72
72 72 72 72 72 72 73 -1 -1 -1 -1 71 72 72 72 72 72 72 72 72
72 72 72 72 72 72 73 -1 -1 -1 -1 71 72 72 72 72 72 72 72 72
