24
18
72 72 72 72 72 72 72 72 73 -1 -1 -1 -1 71 72 72 72 72 72 72 72 72 72 72
72 72 72 72 72 72 72 72 73 -1 -1 -1 -1 71 72 72 72 72 72 72 72 72 72 72
72 72 72 72 72 72 72 72 73 -1 90 -1 -1 71 72 72 72 72 72 72 72 72 72 72
82 82 82 82 82 82 82 82 83 50 51 51 53 81 82 82 82 82 82 82 82 94 72 72
90 90 90 90 90 90 90 90 90 90 90 90 90 90 90 90 90 90 90 90 90 71 72 72
90 90 90 90 90 90 90 90 90 90 90 90 90 90 90 90 90 90 90 90 90 71 72 72
90 90 90 90 90 90 90 90 90 90 90 90 90 90 90 90 90 90 90 90 90 71 72 72
90 90 90 90 90 90 90 90 90 90 90 90 90 61 62 62 62 63 55 56 57 71 72 72
62 62 62 62 62 62 62 62 63 90 90 90 90 71 72 72 72 73 90 90 90 71 72 72
72 72 72 72 72 72 72 72 73 90 90 90 90 81 82 82 82 83 90 90 90 71 72 72
72 72 72 72 72 72 72 72 73 90 -1 -1 -1 90 90 90 90 90 90 90 90 71 72 72
72 72 95 82 82 82 82 82 83 90 55 57 90 90 90 90 90 90 90 90 90 71 72 72
72 72 73 90 90 90 90 90 90 90 -1 90 90 90 90 90 90 -1 90 90 90 71 72 72
72 72 73 90 90 90 90 90 90 90 90 90 -1 76 62 62 62 62 62 62 62 84 72 72
72 72 73 90 90 90 90 90 90 90 90 90 76 90 72 72 72 72 72 72 72 72 72 72
72 72 73 90 90 90 90 90 90 90 90 76 90 72 72 72 72 72 72 72 72 72 72 72
72 72 73 50 51 51 53 61 62 62 62 90 72 72 72 72 72 72 72 72 72 72 72 72
72 72 73 -1 90 90 90 71 72 72 72 72 72 72 72 72 72 72 72 72 72 72 72 72
