32
20
72 72 72 72 72 73 -1 -1 -1 -1 71 72 72 72 72 72 72 72 72 72 72 72 72 72 72 72 72 72 72 72 72 72
72 72 72 72 72 73 -1 -1 -1 -1 71 72 72 72 72 72 72 72 72 72 72 72 72 72 72 72 72 72 72 72 72 72
72 72 72 72 72 73 -1 -1 -1 -1 71 72 72 72 72 72 72 72 72 72 72 72 72 72 72 72 72 72 72 72 72 72
72 72 72 72 72 73 -1 -1 -1 -1 81 82 82 82 82 82 82 82 82 82 82 82 82 82 82 82 82 82 94 72 72 72
82 82 82 82 82 83 50 51 51 53 -1 -1 -1 -1 -1 -1 -1 -1 -1 -1 -1 -1 -1 -1 -1 -1 -1 -1 71 72 72 72
-1 -1 -1 -1 -1 -1 -1 -1 -1 -1 -1 -1 -1 -1 -1 -1 -1 -1 -1 -1 -1 -1 -1 -1 -1 -1 -1 -1 71 72 72 72
-1 -1 -1 -1 -1 -1 -1 -1 -1 -1 -1 -1 -1 -1 -1 -1 -1 -1 -1 -1 -1 -1 -1 -1 -1 -1 -1 -1 71 72 72 72
-1 -1 -1 -1 -1 -1 -1 -1 -1 -1 -1 -1 -1 -1 -1 -1 -1 -1 -1 -1 -1 -1 -1 -1 -1 -1 -1 -1 71 72 72 72
-1 -1 -1 -1 -1 -1 -1 -1 -1 -1 -1 -1 -1 -1 -1 -1 -1 -1 -1 -1 -1 -1 -1 -1 -1 -1 -1 -1 71 72 72 72
62 62 62 62 62 62 63 -1 50 51 51 51 51 51 51 51 53 -1 61 62 62 62 62 63 -1 -1 -1 -1 71 72 72 72
72 72 72 72 72 72 73 -1 -1 -1 -1 -1 -1 -1 -1 -1 -1 -1 71 72 72 72 72 73 -1 -1 -1 -1 71 72 72 72
95 82 82 82 82 82 83 -1 -1 -1 -1 -1 -1 -1 -1 -1 -1 -1 71 72 72 72 72 73 -1 -1 -1 90 71 72 72 72
73 -1 -1 -1 -1 -1 -1 -1 -1 -1 -1 -1 -1 -1 -1 -1 -1 -1 71 72 72 95 82 83 50 51 52 53 81 82 82 82
73 -1 -1 -1 -1 -1 -1 -1 -1 -1 -1 -1 50 51 51 53 -1 -1 71 72 72 73 -1 -1 -1 7 -1 -1 -1 -1 -1 -1
73 -1 -1 -1 -1 -1 -1 -1 -1 -1 -1 -1 -1 -1 -1 -1 -1 -1 71 72 72 73 -1 -1 -1 -1 -1 -1 -1 -1 -1 -1
73 -1 -1 -1 -1 -1 -1 -1 -1 -1 -1 -1 -1 -1 -1 -1 -1 -1 71 72 72 73 -1 -1 -1 -1 -1 -1 -1 -1 -1 -1
85 62 62 62 77 90 90 90 90 90 90 90 90 90 90 90 90 90 71 72 72 73 -1 -1 -1 -1 -1 -1 -1 -1 -1 -1
72 72 72 72 87 62 62 62 62 62 62 62 62 62 62 62 62 62 84 72 72 85 62 63 50 51 52 53 61 62 62 62
72 72 72 72 72 72 72 72 72 72 72 72 72 72 72 72 72 72 72 72 72 72 72 73 -1 -1 -1 -1 71 72 72 72
72 72 72 72 72 72 72 72 72 72 72 72 72 72 72 72 72 72 72 72 72 72 72 73 -1 -1 -1 -1 71 72 72 72
