20
15
-1 -1 -1 -1 -1 -1 -1 -1 -1 -1 -1 -1 -1 -1 10 11 11 12 72 72
-1 -1 -1 -1 -1 -1 -1 -1 -1 -1 -1 -1 -1 -1 10 11 11 12 72 72
-1 -1 0 1 1 1 1 1 1 1 1 1 1 1 42 11 11 12 72 72
-1 -1 10 11 11 11 11 11 11 11 11 11 11 11 11 11 11 12 72 72
-1 -1 10 11 11 11 11 11 11 11 11 11 11 11 7 11 11 12 72 72
-1 -1 10 11 11 11 11 11 11 11 11 11 11 13 17 11 16 12 72 72
-1 -1 10 11 11 11 11 11 11 11 11 11 13 11 27 11 26 12 72 72
-1 -1 10 11 11 11 11 11 11 11 11 11 11 11 37 11 11 12 72 72
1 1 42 11 11 11 11 11 -1 -1 -1 -1 -1 -1 -1 72 -1 22 72 72
11 11 11 11 11 11 11 86 72 72 72 72 72 72 72 72 72 72 72 72
11 11 11 11 11 11 86 72 72 72 72 72 72 72 72 72 72 72 72 72
11 11 11 11 11 86 72 72 72 72 72 72 72 72 72 72 72 72 72 72
-1 -1 -1 -1 86 72 72 72 72 72 72 72 72 72 72 72 72 72 72 72
72 72 72 72 72 72 72 72 72 72 72 72 72 72 72 72 72 72 72 72
72 72 72 72 72 72 72 72 72 72 72 72 72 72 72 72 72 72 72 72
