12
15
72 72 -1 10 11 11 11 11 12 -1 72 72
72 72 -1 10 11 11 11 11 12 58 72 72
72 72 -1 10 11 11 11 11 12 58 72 72
72 72 -1 10 11 11 11 11 12 58 72 72
72 72 -1 10 11 11 11 11 12 58 72 72
72 72 -1 10 11 11 11 11 12 58 72 72
72 72 -1 10 23 11 11 23 12 58 72 72
72 72 -1 10 11 11 11 11 12 58 72 72
72 72 -1 10 23 11 11 11 12 58 72 72
72 72 -1 10 11 11 11 11 12 58 72 72
72 72 -1 10 11 11 11 11 12 58 72 72
72 72 -1 10 23 11 11 23 12 58 72 72
72 72 -1 10 11 11 11 11 12 58 72 72
72 72 -1 10 11 11 11 11 12 58 72 72
72 72 58 10 11 11 11 11 12 58 72 72
