32
20
72 72 72 72 72 -1 10 11 11 12 -1 72 72 72 72 72 72 72 72 72 72 72 72 72 72 72 72 72 72 72 72 72
72 72 72 72 -1 -1 10 11 11 12 -1 72 72 72 72 72 72 72 72 72 72 72 72 72 72 72 72 72 72 72 72 72
72 72 72 72 -1 -1 10 11 11 12 -1 72 72 72 72 72 72 72 72 72 72 72 72 72 72 72 72 72 72 72 72 72
-1 -1 -1 -1 -1 -1 10 11 11 12 -1 -1 -1 -1 -1 -1 -1 -1 -1 -1 -1 -1 -1 -1 -1 -1 -1 -1 -1 72 72 72
-1 -1 -1 -1 -1 -1 10 11 11 40 1 1 1 1 1 1 1 1 1 1 1 1 1 1 1 1 1 2 49 72 72 72
1 1 1 1 1 1 42 11 11 11 11 11 11 11 11 11 11 11 11 11 11 11 11 11 11 11 11 12 -1 72 72 72
11 11 11 11 11 11 11 11 11 11 11 11 11 11 11 11 11 11 11 11 11 11 11 11 11 11 11 12 -1 72 72 72
11 11 11 11 11 11 11 11 11 16 11 11 11 11 11 11 16 11 11 11 11 11 11 11 11 11 11 12 -1 72 72 72
21 21 21 21 21 21 21 31 11 26 11 11 11 11 11 11 26 30 21 21 21 21 21 21 31 11 11 12 -1 72 72 72
-1 -1 -1 -1 -1 -1 -1 10 11 11 11 11 3 4 5 6 11 12 -1 -1 -1 -1 -1 -1 10 11 11 12 -1 72 72 72
72 72 72 72 72 72 -1 10 11 11 11 11 11 14 15 11 11 12 -1 72 72 72 72 -1 10 11 11 12 -1 72 72 72
-1 -1 -1 -1 -1 -1 -1 10 11 11 11 11 11 24 25 11 11 12 -1 72 72 72 72 -1 10 11 11 12 -1 72 72 72
-1 0 1 1 1 1 1 42 11 13 11 11 11 34 35 11 11 12 -1 72 72 72 -1 -1 21 21 21 21 -1 -1 -1 -1
-1 10 11 11 11 11 11 11 13 11 11 11 3 4 5 6 11 12 -1 72 72 -1 0 1 1 1 1 1 1 1 1 1
-1 10 11 11 13 11 11 13 13 13 11 11 11 14 15 11 11 12 -1 72 72 -1 10 23 16 17 16 11 11 11 11 11
-1 20 21 21 11 11 11 11 11 11 11 11 11 24 25 11 11 12 -1 72 72 -1 10 33 26 27 26 11 11 11 11 11
-1 -1 -1 -1 11 21 21 21 21 21 21 21 21 34 35 21 21 22 -1 72 72 -1 20 21 11 37 11 30 21 21 21 21
72 72 72 72 -1 -1 -1 -1 -1 -1 -1 -1 -1 -1 -1 -1 -1 -1 -1 72 72 -1 -1 -1 10 11 11 12 61 62 62 62
72 72 72 72 72 72 72 72 72 72 72 72 72 72 72 72 72 72 72 72 72 72 72 72 10 33 33 12 72 72 72 72
72 72 72 72 72 72 72 72 72 72 72 72 72 72 72 72 72 72 72 72 72 72 72 72 10 33 33 12 72 72 72 72
