30
30
72 72 72 72 72 72 72 72 72 72 72 72 72 72 72 72 72 72 72 72 72 72 72 72 72 72 72 72 72 72
72 72 72 72 72 72 72 72 72 72 72 72 72 72 72 72 72 72 72 72 72 72 72 72 72 72 72 72 72 72
72 72 72 72 72 72 72 72 72 72 72 72 72 72 72 72 72 72 72 72 72 72 72 72 72 72 72 72 72 72
72 72 72 72 72 72 72 72 72 72 72 72 72 72 72 72 72 72 72 72 72 72 72 72 72 72 72 72 72 72
72 72 72 72 72 72 72 95 82 82 82 82 82 82 82 82 82 82 82 82 82 82 94 72 72 72 72 72 72 72
72 72 72 72 72 95 82 83 -1 -1 -1 -1 -1 -1 -1 -1 -1 -1 -1 -1 -1 -1 81 82 94 72 72 72 72 72
72 72 72 95 82 83 -1 -1 -1 -1 -1 -1 -1 -1 90 90 -1 -1 -1 -1 -1 -1 -1 -1 81 82 94 72 72 72
72 72 72 73 -1 -1 -1 -1 -1 -1 -1 -1 -1 -1 90 90 90 90 -1 -1 -1 -1 -1 -1 -1 -1 71 72 72 72
72 72 72 73 -1 -1 -1 -1 -1 -1 -1 -1 -1 90 90 90 90 90 -1 -1 -1 -1 -1 -1 -1 -1 71 72 72 72
72 72 72 73 -1 -1 -1 -1 -1 -1 -1 90 -1 90 90 90 90 90 90 90 -1 -1 -1 -1 -1 -1 71 72 72 72
72 72 72 73 -1 -1 -1 -1 -1 90 90 90 90 90 90 90 90 90 90 90 90 90 90 90 -1 -1 71 72 72 72
72 72 72 73 -1 90 90 90 -1 -1 90 90 90 90 90 90 90 90 90 90 90 90 -1 90 90 -1 71 72 72 72
72 72 72 73 -1 90 90 90 90 90 90 90 90 90 52 52 90 90 90 90 90 90 90 90 -1 -1 71 72 72 72
72 72 72 73 -1 -1 -1 -1 -1 -1 -1 90 90 90 90 90 90 90 -1 -1 -1 -1 -1 -1 -1 -1 71 72 72 72
72 72 72 73 -1 -1 -1 -1 -1 50 51 51 53 90 90 90 90 50 51 51 53 -1 -1 -1 -1 -1 71 72 72 72
72 72 72 73 90 90 90 90 90 90 90 -1 90 90 90 90 90 90 90 90 90 90 90 90 90 90 71 72 72 72
72 72 72 73 90 55 56 57 90 90 90 90 90 90 90 90 -1 90 90 90 -1 -1 55 56 57 59 71 72 72 72
72 72 72 73 90 90 90 90 90 90 90 90 90 90 90 90 90 90 90 90 90 90 90 90 90 90 71 72 72 72
72 72 72 73 -1 -1 -1 90 90 90 90 90 90 90 90 90 90 90 90 90 90 90 90 90 90 90 71 72 72 72
82 82 82 83 58 -1 -1 55 56 57 58 90 90 90 90 90 90 90 90 -1 55 56 57 -1 90 90 81 82 82 82
-1 -1 -1 -1 90 90 90 90 90 90 90 90 90 90 90 90 90 90 90 90 90 90 90 90 90 90 -1 -1 -1 -1
-1 -1 -1 -1 -1 90 90 90 90 90 90 90 90 90 90 90 90 90 90 90 90 90 90 90 90 90 90 90 90 90
-1 -1 -1 -1 -1 55 56 57 -1 56 -1 -1 -1 -1 90 90 90 -1 -1 -1 56 -1 55 56 57 -1 90 90 90 -1
58 58 58 58 58 -1 -1 -1 -1 -1 -1 -1 -1 -1 -1 90 90 -1 -1 -1 -1 -1 -1 -1 -1 -1 -1 -1 -1 -1
62 62 62 62 77 58 -1 -1 -1 -1 -1 -1 -1 -1 -1 -1 -1 -1 -1 -1 -1 -1 -1 -1 -1 76 62 62 62 62
72 72 72 72 90 77 58 -1 -1 -1 -1 -1 -1 -1 -1 -1 -1 -1 -1 -1 -1 -1 90 90 76 90 72 72 72 72
72 72 72 72 72 90 62 62 77 -1 90 -1 -1 -1 -1 -1 -1 49 -1 -1 -1 76 62 62 90 72 72 72 72 72
72 72 72 72 72 72 72 72 90 62 62 62 62 62 62 62 62 62 62 62 62 90 72 72 72 72 72 72 72 72
72 72 72 72 72 72 72 72 72 72 72 72 72 72 72 72 72 72 72 72 72 72 72 72 72 72 72 72 72 72
72 72 72 72 72 72 72 72 72 72 72 72 72 72 72 72 72 72 72 72 72 72 72 72 72 72 72 72 72 72
