30
45
72 72 72 72 72 72 72 72 72 72 72 72 72 72 72 72 72 72 72 72 72 72 72 72 72 72 72 72 72 72
72 72 72 72 72 72 72 72 72 72 72 72 72 72 72 72 72 72 72 72 72 72 72 72 72 72 72 72 72 72
82 82 82 82 82 82 82 82 82 82 82 82 82 82 82 82 82 82 82 82 82 82 82 82 82 82 82 82 82 82
-1 -1 -1 -1 -1 -1 -1 -1 -1 -1 -1 -1 -1 -1 -1 -1 -1 -1 -1 -1 -1 -1 -1 -1 -1 -1 -1 -1 -1 -1
-1 -1 -1 -1 -1 -1 -1 -1 -1 -1 -1 -1 -1 -1 -1 -1 -1 -1 -1 -1 -1 -1 -1 -1 -1 -1 -1 -1 -1 -1
-1 -1 -1 -1 -1 -1 -1 -1 -1 -1 -1 -1 -1 -1 -1 -1 -1 -1 -1 -1 -1 -1 -1 -1 -1 -1 -1 -1 -1 -1
-1 -1 -1 -1 -1 -1 -1 -1 -1 -1 -1 -1 -1 -1 -1 -1 -1 -1 -1 -1 -1 -1 -1 -1 -1 -1 -1 -1 -1 -1
62 62 62 62 62 62 62 62 62 62 62 62 62 62 62 62 62 62 62 62 62 63 50 51 51 51 53 61 62 62
72 72 72 72 72 72 72 72 72 72 72 72 72 72 72 72 72 72 72 72 72 73 -1 -1 -1 -1 -1 71 72 72
72 72 72 72 72 72 72 72 72 72 72 72 72 72 72 72 72 72 72 72 72 73 -1 -1 -1 -1 -1 71 72 72
72 95 82 82 82 82 82 82 82 82 82 82 82 82 82 82 82 82 82 82 82 83 50 51 51 51 53 81 94 72
72 73 -1 -1 -1 -1 -1 -1 -1 -1 -1 -1 -1 -1 -1 -1 -1 -1 -1 -1 -1 -1 -1 -1 -1 -1 -1 -1 71 72
72 73 -1 -1 -1 -1 -1 -1 -1 -1 -1 -1 -1 -1 -1 -1 -1 -1 -1 -1 -1 -1 -1 -1 -1 -1 -1 -1 71 72
72 73 -1 -1 -1 -1 -1 -1 -1 -1 -1 -1 -1 -1 -1 -1 -1 -1 -1 -1 -1 -1 -1 -1 -1 -1 -1 -1 71 72
72 73 -1 -1 -1 -1 90 -1 -1 -1 -1 -1 -1 -1 90 -1 -1 -1 -1 -1 -1 -1 -1 50 51 51 51 53 71 72
72 73 -1 -1 -1 -1 90 -1 -1 -1 -1 -1 -1 -1 90 -1 -1 -1 -1 -1 -1 -1 -1 -1 -1 -1 -1 -1 71 72
72 73 -1 -1 -1 -1 90 -1 -1 -1 -1 -1 -1 -1 90 -1 -1 -1 -1 -1 -1 -1 -1 -1 -1 -1 -1 -1 71 72
72 73 -1 -1 -1 -1 90 -1 -1 -1 -1 -1 -1 -1 90 -1 -1 -1 -1 -1 -1 -1 -1 -1 -1 -1 -1 -1 71 72
72 85 62 62 62 62 62 62 62 62 62 62 62 62 62 62 62 62 62 62 62 63 50 51 51 51 53 -1 71 72
72 72 72 72 72 72 72 72 72 72 72 72 72 72 72 72 72 72 72 72 72 73 -1 -1 -1 -1 -1 -1 71 72
72 95 82 82 82 82 82 82 82 82 82 82 82 82 82 82 82 82 82 94 72 73 -1 -1 -1 -1 -1 -1 71 72
72 73 -1 -1 -1 -1 -1 -1 -1 -1 -1 -1 -1 -1 -1 -1 -1 -1 -1 71 72 73 -1 -1 -1 -1 -1 -1 71 72
72 73 -1 -1 -1 -1 -1 -1 -1 -1 -1 59 59 59 59 59 -1 -1 -1 71 72 73 -1 50 51 51 51 53 71 72
72 73 -1 -1 59 -1 -1 -1 59 -1 -1 59 -1 -1 -1 59 -1 -1 -1 71 72 73 -1 -1 -1 -1 -1 -1 71 72
72 73 -1 -1 59 55 56 57 59 -1 -1 59 55 56 57 59 -1 -1 -1 81 82 83 -1 -1 -1 -1 -1 -1 71 72
72 73 -1 -1 59 -1 -1 -1 59 -1 -1 59 59 59 59 59 -1 -1 59 59 59 59 59 -1 -1 -1 -1 -1 71 72
72 73 -1 -1 -1 -1 -1 -1 -1 -1 -1 -1 -1 -1 -1 -1 -1 -1 59 59 59 59 50 51 51 51 53 -1 71 72
72 73 -1 -1 59 59 59 -1 59 59 59 59 59 59 59 59 59 59 59 59 59 59 59 -1 -1 -1 -1 -1 71 72
72 73 -1 59 55 56 57 59 59 55 56 57 59 59 55 56 57 59 59 59 59 59 59 -1 -1 -1 -1 -1 71 72
72 73 -1 59 59 59 -1 90 59 59 59 59 59 90 -1 -1 -1 -1 59 59 59 90 90 90 -1 90 -1 -1 71 72
72 73 -1 -1 -1 -1 -1 55 52 56 56 52 56 57 -1 -1 -1 -1 -1 61 62 63 90 50 51 51 51 53 71 72
72 73 -1 -1 -1 -1 -1 90 -1 -1 -1 -1 -1 90 -1 -1 -1 -1 -1 71 72 73 90 -1 -1 -1 -1 -1 71 72
72 73 -1 -1 -1 -1 -1 90 -1 -1 -1 -1 -1 90 -1 -1 -1 -1 -1 71 72 73 90 -1 -1 -1 -1 -1 71 72
72 73 -1 90 90 -1 -1 90 -1 -1 90 -1 -1 90 -1 -1 -1 90 -1 71 72 73 90 -1 -1 -1 -1 -1 71 72
72 85 62 62 62 62 62 62 62 62 62 62 62 62 62 62 62 62 62 84 72 73 50 51 51 51 53 -1 71 72
72 72 72 72 72 72 72 72 72 72 72 72 72 72 72 72 72 72 72 72 72 73 90 -1 -1 -1 -1 -1 71 72
72 72 72 72 72 72 72 72 72 72 72 72 72 72 72 72 72 72 72 72 72 73 90 -1 -1 -1 -1 -1 71 72
72 95 82 82 82 82 82 82 82 82 82 82 82 82 82 82 82 82 82 82 82 83 90 50 51 51 51 53 71 72
72 73 90 -1 -1 -1 -1 -1 -1 -1 -1 -1 -1 -1 -1 -1 -1 -1 -1 -1 -1 -1 -1 -1 -1 -1 -1 -1 71 72
72 73 90 -1 -1 -1 -1 -1 -1 -1 -1 -1 -1 -1 -1 -1 -1 -1 -1 -1 -1 -1 -1 -1 -1 -1 -1 -1 71 72
72 73 90 -1 -1 -1 -1 -1 -1 -1 -1 -1 -1 -1 -1 -1 -1 -1 -1 -1 -1 -1 -1 -1 -1 -1 -1 -1 71 72
72 73 90 -1 -1 -1 -1 -1 -1 -1 -1 -1 -1 -1 -1 -1 -1 -1 -1 -1 -1 -1 90 90 90 90 90 90 71 72
72 85 62 62 63 50 51 52 53 61 62 62 62 62 62 62 62 62 62 62 62 62 62 62 62 62 62 62 84 72
72 72 72 72 73 90 90 90 90 71 72 72 72 72 72 72 72 72 72 72 72 72 72 72 72 72 72 72 72 72
72 72 72 72 73 90 90 90 90 71 72 72 72 72 72 72 72 72 72 72 72 72 72 72 72 72 72 72 72 72
