20
15
72 72 72 72 72 72 72 72 72 72 72 72 72 73 -1 -1 -1 -1 71 72
72 95 82 82 82 82 82 82 82 82 82 82 82 83 55 56 52 57 71 72
72 73 -1 -1 -1 -1 -1 -1 -1 -1 -1 -1 -1 -1 -1 -1 -1 -1 71 72
72 73 -1 -1 -1 -1 -1 -1 -1 -1 -1 -1 -1 -1 -1 -1 -1 -1 71 72
72 73 -1 -1 -1 -1 -1 -1 -1 -1 -1 -1 -1 -1 55 56 52 57 71 72
72 73 -1 -1 -1 -1 -1 -1 -1 -1 -1 -1 -1 -1 -1 -1 -1 -1 71 72
72 73 -1 -1 -1 -1 -1 -1 -1 -1 -1 -1 -1 -1 -1 -1 -1 -1 71 72
82 83 -1 -1 -1 -1 -1 -1 -1 -1 -1 -1 -1 -1 -1 -1 -1 90 71 72
-1 -1 -1 -1 -1 -1 -1 76 62 62 62 62 62 62 62 62 62 62 84 72
-1 -1 -1 -1 -1 -1 76 90 72 72 72 72 72 72 72 72 72 72 72 72
-1 -1 -1 -1 -1 76 90 72 72 72 72 72 72 72 72 72 72 72 72 72
-1 -1 -1 -1 76 90 72 72 72 72 72 72 72 72 72 72 72 72 72 72
62 62 62 62 90 72 72 72 72 72 72 72 72 72 72 72 72 72 72 72
72 72 72 72 72 72 72 72 72 72 72 72 72 72 72 72 72 72 72 72
72 72 72 72 72 72 72 72 72 72 72 72 72 72 72 72 72 72 72 72
