30
20
72 72 72 72 72 72 73 -1 -1 -1 90 71 72 72 72 72 72 72 72 72 72 72 72 72 72 72 72 72 72 72
72 72 72 72 72 72 73 -1 -1 -1 90 71 72 72 72 72 72 72 72 72 72 72 72 72 72 72 72 72 72 72
72 72 72 95 82 82 83 50 51 51 53 81 82 82 82 82 82 82 82 82 82 82 82 82 82 94 72 72 72 72
72 72 72 73 -1 -1 -1 -1 -1 90 -1 -1 -1 -1 -1 -1 -1 -1 -1 -1 -1 -1 -1 65 65 81 94 72 72 72
72 72 72 73 -1 -1 -1 -1 -1 -1 -1 -1 -1 -1 -1 -1 -1 -1 -1 -1 -1 -1 65 65 65 -1 71 72 72 72
72 72 72 73 -1 -1 -1 -1 -1 -1 -1 -1 -1 -1 -1 -1 -1 -1 -1 -1 -1 -1 -1 -1 -1 -1 71 72 72 72
72 72 72 73 -1 -1 -1 50 51 51 53 -1 -1 -1 -1 -1 -1 -1 -1 -1 -1 -1 -1 -1 -1 -1 71 72 72 72
72 72 72 73 -1 -1 -1 -1 -1 -1 -1 -1 -1 -1 -1 -1 -1 61 62 63 -1 -1 -1 -1 -1 -1 71 72 72 72
72 72 72 73 -1 -1 -1 -1 -1 -1 -1 55 56 57 -1 -1 -1 71 72 73 -1 -1 -1 -1 -1 -1 71 72 72 72
72 72 72 73 -1 -1 -1 -1 -1 -1 -1 -1 -1 -1 -1 -1 -1 81 82 83 -1 -1 -1 -1 -1 -1 71 72 72 72
72 72 72 73 -1 -1 -1 -1 -1 55 56 57 -1 55 56 57 -1 -1 -1 -1 -1 -1 55 56 56 57 71 72 72 72
72 72 72 73 -1 -1 -1 -1 -1 -1 -1 -1 -1 -1 -1 -1 -1 -1 -1 -1 -1 -1 -1 -1 -1 -1 81 82 82 82
72 72 72 73 -1 -1 -1 -1 -1 -1 -1 55 56 57 -1 -1 -1 -1 -1 -1 -1 -1 -1 -1 -1 -1 -1 -1 -1 -1
72 72 72 73 -1 -1 -1 -1 -1 -1 -1 -1 -1 -1 -1 -1 -1 -1 -1 -1 -1 -1 -1 -1 -1 -1 -1 -1 -1 -1
72 72 72 73 -1 -1 -1 -1 -1 55 56 57 -1 55 56 57 -1 -1 -1 -1 -1 -1 -1 -1 -1 -1 -1 -1 -1 -1
72 72 72 73 -1 -1 -1 -1 -1 -1 -1 -1 -1 -1 -1 -1 -1 -1 -1 -1 -1 -1 -1 90 90 -1 -1 90 90 -1
72 72 72 85 62 62 62 62 62 62 62 62 62 62 62 62 62 62 62 62 62 63 50 51 51 53 61 62 62 62
72 72 72 72 72 72 72 72 72 72 72 72 72 72 72 72 72 72 72 72 72 73 -1 90 90 -1 71 72 72 72
72 72 72 72 72 72 72 72 72 72 72 72 72 72 72 72 72 72 72 72 72 73 -1 -1 -1 -1 71 72 72 72
72 72 72 72 72 72 72 72 72 72 72 72 72 72 72 72 72 72 72 72 72 73 -1 -1 -1 -1 71 72 72 72
