24
20
72 72 72 72 72 72 72 72 72 72 10 11 11 12 72 72 72 72 72 72 72 72 72 72
72 72 72 72 72 72 72 72 72 72 10 11 11 12 72 72 72 72 72 72 72 72 72 72
72 72 72 72 72 72 72 72 72 72 10 11 11 12 72 72 72 72 72 72 72 72 72 72
72 72 72 72 72 72 72 72 72 72 10 11 11 12 72 72 72 72 72 72 72 72 72 72
72 67 67 -1 -1 -1 -1 -1 -1 -1 10 11 11 12 -1 -1 -1 -1 -1 -1 -1 -1 -1 72
72 -1 0 1 1 1 1 1 1 1 42 11 11 40 1 1 1 1 1 1 1 2 -1 72
72 -1 10 11 11 11 11 11 11 11 11 11 11 11 11 11 11 11 11 11 11 12 -1 72
72 -1 10 11 21 21 21 11 11 11 11 11 11 11 11 11 11 21 21 21 11 12 -1 72
72 -1 10 11 -1 -1 -1 11 11 11 21 21 21 21 11 11 11 11 -1 11 11 12 -1 72
72 -1 10 11 -1 -1 -1 11 11 11 3 4 5 6 11 11 11 -1 -1 -1 11 12 -1 72
72 -1 10 11 -1 -1 -1 11 11 11 11 14 15 11 11 11 11 -1 -1 -1 11 12 -1 72
72 -1 10 11 11 11 11 11 11 11 11 24 25 11 11 11 11 11 11 11 11 12 -1 72
72 -1 10 11 11 11 11 11 11 11 11 34 35 11 30 11 11 11 11 11 11 12 -1 72
72 -1 10 11 11 11 11 11 -1 10 11 11 11 11 12 -1 11 11 11 11 11 12 -1 72
72 -1 10 11 11 11 11 86 -1 10 11 11 11 11 12 -1 87 11 11 11 11 12 -1 72
72 -1 10 11 11 11 86 72 72 10 11 11 11 11 12 -1 72 87 11 11 11 12 -1 72
72 -1 10 11 11 86 72 72 -1 20 21 21 21 21 22 -1 72 72 87 11 11 12 -1 72
72 -1 -1 -1 86 72 72 72 -1 -1 -1 -1 -1 -1 -1 -1 72 72 -1 87 -1 -1 -1 72
72 72 72 72 72 72 72 72 72 72 72 72 72 72 72 72 72 72 72 72 72 72 72 72
72 72 72 72 72 72 72 72 72 72 72 72 72 72 72 72 72 72 72 72 72 72 72 72
