24
18
72 72 72 72 72 72 72 72 -1 11 11 11 11 -1 72 72 72 72 72 72 72 72 72 72
72 72 72 72 72 72 72 72 -1 11 11 11 11 -1 72 72 72 72 72 72 72 72 72 72
72 72 72 72 72 72 72 72 -1 11 11 11 11 -1 72 72 72 72 72 72 72 72 72 72
-1 -1 -1 -1 -1 -1 -1 -1 -1 11 11 11 11 -1 -1 -1 -1 -1 -1 -1 -1 -1 72 72
1 7 1 1 1 1 1 7 1 11 11 11 11 1 1 1 1 1 1 1 2 -1 72 72
11 17 11 11 11 11 11 17 11 11 11 11 11 11 11 11 11 11 11 11 12 -1 72 72
11 27 11 16 11 16 11 27 11 11 11 11 11 11 11 11 11 11 11 11 12 -1 72 72
11 37 11 26 11 26 11 37 11 11 11 11 11 -1 -1 -1 -1 -1 10 11 12 -1 72 72
-1 -1 -1 -1 -1 -1 -1 -1 -1 11 11 11 11 -1 -1 -1 -1 -1 10 11 12 -1 72 72
72 72 72 72 72 72 72 72 -1 11 11 11 11 -1 -1 -1 -1 -1 10 11 12 -1 72 72
72 72 72 72 72 72 72 72 -1 11 11 11 11 1 1 1 1 1 42 11 12 -1 72 72
72 72 -1 -1 -1 -1 -1 -1 -1 11 11 11 11 11 11 11 11 11 11 11 12 -1 72 72
72 72 -1 0 1 1 1 7 1 11 11 11 11 11 21 21 21 21 21 21 22 -1 72 72
72 72 -1 10 11 11 11 17 11 11 11 11 11 11 -1 -1 -1 -1 -1 -1 -1 -1 72 72
72 72 -1 10 11 11 11 27 11 11 11 11 11 86 72 72 72 72 72 72 72 72 72 72
72 72 -1 10 11 11 11 37 11 11 11 11 86 72 72 72 72 72 72 72 72 72 72 72
72 72 -1 10 11 11 12 -1 -1 -1 -1 86 72 72 72 72 72 72 72 72 72 72 72 72
72 72 -1 10 11 11 12 -1 72 72 72 72 72 72 72 72 72 72 72 72 72 72 72 72
