20
15
72 72 72 72 72 72 72 72 72 72 72 72 72 72 72 72 72 72 72 72
72 72 72 72 72 72 72 72 72 72 72 72 72 72 72 72 72 72 72 72
72 72 72 95 82 82 82 82 82 82 82 82 82 82 82 82 94 72 72 72
72 95 82 83 90 90 90 90 90 90 90 90 90 90 90 90 81 94 72 72
72 73 90 90 90 90 90 90 90 90 90 90 90 90 90 90 90 71 72 72
72 73 90 90 90 90 61 62 62 62 62 62 63 90 90 90 90 71 72 72
72 73 90 90 90 90 81 82 82 82 82 82 83 90 90 90 90 71 72 72
72 73 90 90 90 90 90 90 90 90 90 90 90 90 90 90 90 71 72 72
72 73 90 90 90 90 90 90 90 90 90 90 90 90 90 90 90 71 72 72
72 73 90 90 55 52 56 57 -1 90 -1 55 52 52 57 90 90 71 72 72
72 87 77 90 90 90 90 90 90 90 90 90 90 90 90 90 76 86 72 72
72 72 90 77 90 90 90 90 90 90 90 90 90 90 90 76 90 72 72 72
72 72 72 90 77 90 90 90 90 90 90 90 90 90 76 90 72 72 72 72
72 72 72 72 90 62 63 55 56 56 56 57 61 62 90 72 72 72 72 72
72 72 72 72 72 72 73 90 90 90 90 90 71 72 72 72 72 72 72 72
