20
20
72 72 72 72 72 72 72 72 72 72 72 72 72 72 72 72 72 72 72 72
72 72 72 72 72 72 72 72 72 72 72 72 72 72 72 72 72 72 72 72
72 72 72 -1 -1 -1 -1 -1 -1 -1 -1 -1 -1 -1 72 72 72 72 72 72
72 72 72 -1 0 1 1 1 1 1 1 1 2 -1 72 72 72 72 72 72
72 72 72 -1 10 11 11 11 11 11 11 11 12 -1 72 72 72 72 72 72
72 72 -1 -1 10 11 11 11 11 11 11 11 12 -1 -1 -1 -1 -1 -1 72
72 72 -1 0 42 11 11 11 11 11 11 11 11 7 1 1 1 1 -1 72
72 72 -1 10 11 11 11 11 11 11 11 11 11 17 11 11 11 11 -1 72
72 72 -1 10 11 11 11 11 11 11 11 11 11 27 11 11 11 11 -1 72
72 72 -1 10 11 11 11 11 11 11 11 11 11 37 11 11 11 11 -1 72
72 72 -1 10 11 11 12 -1 -1 -1 -1 -1 -1 -1 -1 11 11 11 -1 72
72 72 -1 10 11 11 12 -1 -1 -1 -1 -1 -1 -1 -1 11 11 11 -1 72
72 72 -1 10 11 11 12 -1 -1 -1 -1 -1 -1 -1 -1 11 11 11 -1 72
1 1 1 42 11 11 40 1 1 1 1 3 4 5 6 11 11 11 7 1
11 11 17 11 11 11 11 11 11 11 11 11 14 15 11 11 11 11 17 11
11 11 27 11 11 11 11 11 11 11 11 11 24 25 11 11 11 11 27 11
11 11 37 11 11 11 11 11 11 11 11 11 34 35 11 11 11 11 37 11
-1 -1 -1 -1 -1 -1 -1 11 11 11 11 -1 -1 -1 -1 -1 -1 -1 -1 -1
72 72 72 72 72 72 -1 11 11 11 11 90 -1 72 72 72 72 72 72 72
72 72 72 72 72 72 -1 11 11 11 11 -1 -1 72 72 72 72 72 72 72
